#.#############################
#.......#.#.......#...#...#...#
###.#.###.#.#.#####.###.###.#.#
#...#...#...#.........#.....#.#
#####.#########.#.#########.#.#
#.....#.#...#...#.#...#...#.#.#
#.#.#.#.###.###.###.###.###.###
#.#.#.#...#...#...........#...#
#####.#.###.#.###.#.#########.#
#.#.#.......#.....#...#.......#
#.#.#.#####.#.#######.#####.###
#...#.....#.#.....#...#.......#
###.###.#.###.#.###.#.###.#####
#.....#.#.#.#.#.#.#.#.........#
#.#.#.#####.#.###.###.#.###.#.#
#.#.#.....#...#.......#.#.#.#.#
#.#.#.###.###.#####.###.#.#####
#.#.#...#.......#.....#.......#
#.###.#########.#.#.#####.###.#
#.#.....#.......#.#.#.....#.#.#
#.#######.#.#######.#####.#.###
#.....#.#.#.#.#.#.#.....#.....#
#.#####.###.#.#.#.#.#.#######.#
#...#.......#.#.#...#.#.....#.#
#########.#.#.#.#.#####.#######
#...#.....#.....#.....#...#.#.#
#.###.#.#.#####.#####.###.#.#.#
#.....#.#...#...#...........#.#
#.#.#.###.###.#####.#.#######.#
#.#.#...#...#.....#.#.........#
#############################.#
